mZZJYDfmgeg	Arts and Entertainment
XN3N5K2axpw	Arts and Entertainment
WIIjq2GexIw	Arts and Entertainment
ZT1dvq6yacQ	Arts and Entertainment
du0XaCl25iQ	Arts and Entertainment
VEplLGXFLFw	Arts and Entertainment
EYL1tYGwYY0	Arts and Entertainment
uUBVc8Ugz0k	Arts and Entertainment
Nu_By3eTpoc	Arts and Entertainment
lLhaKBvgyNQ	Arts and Entertainment
    
	
2OoebJA2mnE	Cars & Other Vehicles
-xCtbeecgKQ	Cars & Other Vehicles
-6tnn1G1dRg	Cars & Other Vehicles
z1Xv6Pa0toE	Cars & Other Vehicles
T622Ec77ZPY	Cars & Other Vehicles
HCi5TT5JNCU	Cars & Other Vehicles
jhAklPzn0XQ	Cars & Other Vehicles
QzS7Z80poKo	Cars & Other Vehicles
bwxvH99sLqw	Cars & Other Vehicles
5PdAtcoWWeM	Cars & Other Vehicles
	
	
0SMzqWV6xxs	Computers and Electronics
_Yb6xLqvsf0	Computers and Electronics
nnzPJv5XIws	Computers and Electronics
ZORD4y7dL08	Computers and Electronics
-szevr-BRZE	Computers and Electronics
KLLqGcgxQEw	Computers and Electronics
Czi_ZirnzRo	Computers and Electronics
GFd7kLvhc2Q	Computers and Electronics
73lxEIKyX8M	Computers and Electronics
eDG1c6a6uqc	Computers and Electronics
	
Rcsy2HRuiyA	Education and Communications
Ag6D8RGQnjw	Education and Communications
CxdRXDN1fkA	Education and Communications
dJ_qCDWNvXU	Education and Communications
VDMOFa8iRqo	Education and Communications
mQjCKgEPs8k	Education and Communications
BzxPDw6ezEc	Education and Communications
om0a083q2Jo	Education and Communications
ZmTxw3UbMO4	Education and Communications
kz5dJ9SCu4M	Education and Communications

yJ7VzfG2ONo	Food and Entertaining
JNznnqX6SsE	Food and Entertaining
dKUomyn1TYQ	Food and Entertaining
h281yamVFDc	Food and Entertaining
5AU2vJU-QJM	Food and Entertaining
yYOysPt5gic	Food and Entertaining
xgy-swzccho	Food and Entertaining
ZY11rbwCaMM	Food and Entertaining
xTARWxkTJw0	Food and Entertaining
WcD8bG2VB_s	Food and Entertaining
	
	
A_qivvTkijw	Hobbies and Crafts
S0luUzNRtq0	Hobbies and Crafts
eyD2iwXOeFM	Hobbies and Crafts
kPGwDxo5Yf4	Hobbies and Crafts
bg3orsnRCVE	Hobbies and Crafts
HFp5uH12wkc	Hobbies and Crafts
Xh_Awznyc7s	Hobbies and Crafts
jHsbUTwIl1A	Hobbies and Crafts
cGn_oZPotZA	Hobbies and Crafts
yu-G9kEKdTo	Hobbies and Crafts
	
	
Cvv1wiqKMHc	Holidays and Traditions
EnjZHOb6qNE	Holidays and Traditions
r6JmI35r5E8	Holidays and Traditions
AnWGek4P_dY	Holidays and Traditions
7IcOJEEObA0	Holidays and Traditions
R7fBwFAq7TI	Holidays and Traditions
IICwmc4WX2E	Holidays and Traditions
Eeu5uL6r2rg	Holidays and Traditions
k0koOhfXv_s	Holidays and Traditions
4WaXJs9RR3E	Holidays and Traditions
	
ta5IB2wy6ic	Health
rqBiByEbMHc	Health
2YGEDsl7PO8	Health
0TLQg_b1v5Q	Health
1Ni8KOzRzuI	Health
sM81wJ7GDrI	Health
Vrz25x3qnTY	Health
sij_wNj0doI	Health
sPRbnJzKEys	Health
r1EVYbOj-vI	Health

tb1L7Rsm1U8	Home and Garden
T1j7Yq5-cIs	Home and Garden
ihCwjLj31hY	Home and Garden
2Xyfgwj92v0	Home and Garden
mwpb65gm1e0	Home and Garden
oe7Cz-dxSBY	Home and Garden
zMqzjMrxNR0	Home and Garden
UZJ0nmB3epQ	Home and Garden
8cV5x4jP7EU	Home and Garden
0fxL8v2dMho	Home and Garden
	
	
8DgsLNa3ums	Personal Care and Style
N3c81EPZ51Q	Personal Care and Style
e3StC_4qemI	Personal Care and Style
ntYwKXN82QU	Personal Care and Style
s4coMAU80U4	Personal Care and Style
7oXrT1CqLCY	Personal Care and Style
uMgpr6X5asI	Personal Care and Style
AbhW9YbQ0fM	Personal Care and Style
bQKTjz0JKhg	Personal Care and Style
SXQHgJHYQgc	Personal Care and Style
	
	
Df9F8ettY8k	Pets and Animals
ntwi2Unh3JQ	Pets and Animals
RhB72g8K2Aw	Pets and Animals
OcjCNqfRgP0	Pets and Animals
WoDZQRGyuHA	Pets and Animals
wvC3_Rs4mXs	Pets and Animals
bxXXCP0AE5A	Pets and Animals
2xXPSfQBP-w	Pets and Animals
yeT52sDtYEU	Pets and Animals
QP6eCND84w0	Pets and Animals
	
XFYHIg8U--4	Sports and Fitness
m0H56KpKLHA	Sports and Fitness
1dALzTPQWJg	Sports and Fitness
jGsEBwiKnCI	Sports and Fitness
kNsjE4HO7tE	Sports and Fitness
ygRQRgR11Zg	Sports and Fitness
mj1Fu3-XQpI	Sports and Fitness
CdZQF4DDAxM	Sports and Fitness
brUJ0h5GqrU	Sports and Fitness
b2EZggyT5O4	Sports and Fitness